urlHelp=help/index.html
lastSaved=Último salvo
currentFile=Current File
toolbar=Barra de ferramenta
save=Salvar
print=Imprimir
cut=Cortar
copy=Copiar
paste=Colar
delete=Excluir
undo=Desfazer
redo=Refazer
select=Selecionar
connect=Conectar
pan=Pan
zoomIn=Aumentar zoom
zoomOut=Reduzir zoom
zoom=Zoom
fit=Encaixar
actualSize=Tamanho atual
selectAll=Selecionar tudo
clearSelection=Limpar seleção
shape=Shape
format=Formato
font=Fonte
group=Agrupar
ungroup=Desagrupar
removeFromParent=Remover do parente
align=Alinhar
left=Esquerda
right=Direita
center=Centro
top=Cima
middle=Meio
bottom=Baixo
collapse=Diminuir
expand=Expandir
toBack=Enviar para trás
toFront=Enviar para frente
enterGroup=Entrar no grupo
exitGroup=Sair do grupo
layout=Layout
horizontalTree=Horizontal Tree
verticalTree=Vertical Tree
fillColor=Preenchimento
strokeColor=Cor da linha
gradientColor=Cor gradiente
bold=Negrito
italic=Itálico
fontColor=Cor da fonte
fontSize=Tamanho da fonte
fontFamily=Fonte
examples=Exemplos
newDiagram=Novo Diagrama
image=Imagem
opacity=Opacidade
selection=Seleção
editStyle=Editar estilo
enterStyle=Definir estilo
enterColorname=Definir por nome da cor
enterImageUrl=Inserir url da imagem
enterOpacity=Inserir opacidade (%)
enterFontsize=Inserir tamanho da fonte (pt)
enterFontfamily=Inserir nome da fonte
toggleRounded=Arredondado
toggleShadow=Sombra
openHref=Abrir URL
show=Mostrar
exportImage=Exportar imagem
exportSvg=Exportar SVG
changesLost=Todas as alterações foram perdidas!
swimlanes=Swimlanes
travelBooking=Reserva de viagens
notAvailable=Não disponível